WE image/bluestone.png   
N  image/redbrick.png
EA image/eagle.png
SO image/wood.png
C 100,30,15
F 150,50,25

                            1111111111111                      
     111111                 1000000000001                      
     100001      1111111111111000000000011111                  
     100001      1000000000010000000000010001                  
     1000001     1000000000000000000000000001                  
     1000001     1000000000010000100000010001                  
     11111111111 1000111111110000N0000011111                  
     10000000001 10001      100001000001                      
     1000000000111000111     11111111111                      
     1000000000100000001        10001                          
     1000001000000000001        10001                          
     1000000000100000001        10001                          
111111000000000111111111        10001           
1000110000000001                10001                          
100011111101111            111111000111                        
1000100010001              100100000001                        
1101100010001              100111000111                        
1000111110001              1001110001                          
1000100010001              1001110001                          
1000000010001              1111110001                          
1000100010001                   10001                          
1000111111011111                11011                1111111111
1000110000000001          111111000001111111         1000000001
1000110000000001          100000001000000011         1000000001
1000110000000001          1000000000000000111111111111000000001
1000010000000001          1000000010000000010000000001000000001
1000000000000001          1000000000000000000000000000000000001
1000010000000001          1000000000000000010000000001000000001
1000110000000001          1000000000000000111100001111000000001
1000110000000001          100000000000000011111001   1000000001
1000110000000001          11111100000111111   1001   1000000001
1000111111011111               111011         1001   1110110111
1000111110001                   10001         1001   1111111111
1000111110001                   10001         1001             
1000100010001                   10001         100111111111111  
1000000010001                   10001         100111010101011  
1000100010001                   10001         100010000000001  
1000111110001                   10001         100000000000001  
1000111110001111111111111       10001         100010000000001  
100000000000000001000000111     10001         100010010101001  
100000000000000000000000001     10001          1111111111111  
10000000000000001000000111      10001                          
1111111111111111111111111       10001                          
          11001001001      11111111111111                     
         10000100101       100001000100001                     
          110000011        100000000000001                     
            111111         100001000100001                     
            1001           100001000100001                     
            1001           11111111111111                     
            1111           100001000100001                     
                           100000000000001                     
                           100001000100001                     
                           111111000111111                     
                           100000000000001                     
                           100000000000001                     
                           100000000000001                     
                           11111111111111        